.....................-@
......#...#...........@
........###...###.....@
................##....@
#........#.#..........@
.........#...####.....@
...#....#..........#..@
.....####.........##..@
......#....###.....#..@
........##............@
.........##...####....@
.....................+@
44, 1, 0, 0, 5
59, 1, 3, 0, 5
35223, 1208, 772, 581, 6620